goal - гол
suit  - костюм
feature  - blog
particularly  - особенно
flaws - Слабости
security-conscious - заботящийся о безопасности
consider  - считать
be used within software-based experiences - использоваться в программном обеспечении
speculation  - спекуляция
inspire  - Вдохновение
insidious  - Коварный
the move won’t inspire state-sponsored hackers  - этот шаг не вдохновит спонсируемых государством хакеров
confirmed  - подтвержденный
also suggests - также предлагает
within  - в пределах
 sift through - просеивать
more contextually aware - более контекстуально осведомлены
fluid - плавающее
responsive  - адаптивность
reliant  - reliant
including groups of actions reliant on different apps - включая группы действий, зависящие от разных приложений
accelerating pace - ускорение темпа
well-timed reports  - своевременные отчеты
sense - чувствовать
weaving  - Ткачество
teams are weaving generative AI  - команды ткут генеративный ИИ

hello - здравствуйте
articulations соединения
The latter implies - Последнее подразумевает
extent  - экстент, область памяти
acceleration  - ускорение
The ceiling of the possible remains unmet. - Потолок возможного остается не забитым.
Bear in mind that - Имейте в виду, что!
 considering an enterprise as secretive as Apple, - считая предприятие таким же скрытным, как Apple,
leeway to seek - простор для поиска
though - хотя
upon  - .
folders upon folders  - папки по папкам
clunky  - неуклюжий
productivity powerhouse - электростанция производительности
breakdown  - &amp;
Beneath that, - Под этим,
odds are - шансы
plug  - пробка
essentially  - По существу,
on any of those fronts, - на любом из этих фронтов,
comprehensive  - комплексных
embrace  - заключать в себе
significantly  - значимо
effort - усилие
appropriate  - где необходимо
surgical  - Для хирургии
 more than a dozen mixed-reality  - более дюжины смешанной реальности
optometry applications, surgical tools, and remote-care solutions - приложения для оптометрии, хирургические инструменты и решения для дистанционного ухода
usher  - Mary J.
spinal  - Позвоночное
effortlessly efficient - без усилий эффективный
sophisticated  - Factors of Production
efficient tumor  - эффективная опухоль
